







111111111111111111111111111111111111111111111111111111111111
1C000000000001100000000000C000000000000000000000000000000001
101111011111011011111011110000000000000000000000000000000001
101111C11111011011111C11110000000000000000000000000000000001
101111011111011011111011110000000000000000000000000000000011
100000000000000000000000000000000000000000000000000000000011
101111011011111111011011110000000000000000000000000000000011
101111011011111111011011110000000000000000000000000000000011
100000011000011000011000000000000000000000000000000000000011
100000011000011000011000000000000000000000000000000000000011
101111011000000000011011110000000000000000000000000000000011
101111011011100111011011110000000000000000000000000000000011
100000011010000001011000000000000000000000000000000000000011
10000001101E0000P1011000000000000000000000000000000000000011
101111011011111111011011110000000000000000000000000000000011
101111011000000000011011110000000000000000000000000000000011
100000011000011000011000000000000000000000000000000000000011
100000011000011000011000000000000000000000000000000000000011
101111011011111111011011110000000000000000000000000000000011
101111011011111111011011110000000000000000000000000000000011
100000000000000000000000000000000000000000000000000000000011
101111011111011011111011110000000000000000000000000000000011
101111C11111011011111C11110000000000000000000000000000000011
101111011111011011111011110000000000000000000000000000000011
1C000000000001100000000000C000000000000000000000000000000011
111111111111111111111111111111111111111111111111111111111111









