11111111111
10P000E0001
10000000001
11111111111