11111111111
10C000E0001
10000000001
11111111111